+-------------+-------------------------------------------------+-------------+
|             |                                                 |             |
|             |                                                 |             |
|             |                                                 |             |
|             |                                                 |             |
|             |                                                 |             |
|             |                                                 |             |
|             |                                                 |             |
|             |                                                 |             |
|             |                                                 |             |
|             |                                                 |             |
|             |                                                 |             |
|             |                                                 |             |
|             |                                                 |             |
|             |                                                 |             |
|             |                                                 |             |
|             |                                                 |             |
|             |                                                 |             |
|             |                                                 |             |
|             |                                                 |             |
|             |                                                 |             |
|             |                                                 |             |
|             |                                                 |             |
|             |                                                 |             |
|             |                                                 |             |
|             |                                                 |             |
|             |                                                 |             |
|             |                                                 |             |
|             |                                                 |             |
|             |                                                 |             |
|             |                                                 |             |
|             |                                                 |             |
|             |                                                 |             |
|             |                                                 |             |
|             |                                                 |             |
|             |                                                 |             |
|             +-------------------------------------------------+             |
|             |                                                 |             |
|             |                                                 |             |
|             |                                                 |             |
|             |                                                 |             |
|             |                                                 |             |
|             |                                                 |             |
|             |                                                 |             |
|             |                                                 |             |
|             |                                                 |             |
|             |                                                 |             |
|             |                                                 |             |
|             |                                                 |             |
+-------------+-------------------------------------------------+-------------+
